1.......
11......
.11.....
..11....
...11...
....11..
.....11.
......11
......11
..11..11
..11....
..11....
..11....
..11....
..11....
..11....
..11....
..11....
1111.111
1111.111
1111.111
1111.111


